,10th,11th,12th,Total,Number of teachers
Art,31,33,35,99,1
Biology,198,95,26,319,4
Chemistry,59,126,109,294,3
English,183,155,152,490,5
French,41,32,49,122,1
German ,19,22,10,51,1
Spanish,51,26,33,110,1
Mathematics,184,201,262,647,6
Music,50,56,49,155,1
Physics,50,58,183,291,3
Social Studies,183,131,59,373,5
